................
................
................
................
.............##.
@..###....###...
###....###......