+....................................................
..................................................../
.....................................................
.........@..######.........................##........
....................###..###...........#.............
.........###.....###.........##.....#............##.
#########.......................##..................
-----------------------------------------------------

